............
............
............
............
............
...*........
..XXX.....1.
..XXX....XXX
..XXX....XXX
..XXX.2..XXX