...................
.................*.
....XXXXX..........
............XXXXXXX
XX.................
...................
....XXXXXXX........
...................
.............XXXXXX
.1...........XXXXXX