..................
..................
..XXXX............
.................1
...........XXXXXXX
......2...........
.....XXX..........
.....XXX..........
..XXXXXXXXXX......
..XXXXXXXXXX...*..