...................
.........*.........
...................
...................
1.XX...........XX.2
XXXX...........XXXX
XXXX...........XXXX
XXXX...........XXXX
XXXXX.........XXXXX
XXXXXXX.....XXXXXXX
