..................
..................
..XXXX............
...............1..
...........XXXXXXX
..................
.....XXX..........
.....XXX..........
..XXXXXXXXXX......
..XXXXXXXXXX...*..