...................
.........*.........
........XXX........
........XXX........
.....XXXXXXXXX.....
XXX.............XXX
...................
....XXXXXXXXXXX....
...................
XX.......1.......XX