...................
.................*.
...................
............XXXX...
.1XX...............
XXXX...............
XXXXXXXXX..........
XXXXXXXXX..........
XXXXXXXXXXXXXX.....
XXXXXXXXXXXXXX.....