...................
.........*.........
................X.1
................XXX
................XXX
.............XXXXXX
......XXXXXXXXXXXXX
...XXXXXXXXXXXXXXXX
...XXXXXXXXXXXXXXXX
.2.XXXXXXXXXXXXXXXX