...................
.................*.
...................
.1..........XXXX...
XXXX...............
XXXX...............
XXXXXXXXX..........
XXXXXXXXX..........
XXXXXXXXXXXXXX.....
XXXXXXXXXXXXXX.....